# A province can only belong to one area!

#Sea Areas:
#No restriction on size.

atlantica_area = {
	238 239 240 241 242 243 244 245 246 247 248 249 250 251 252 253 254 255 256 257 258 259 260 261 262 263 264 265 266 267
	268 269 270 271 272 273 274 275 276 277 278 279 280 281 282 283 284 285 286 287 288 289 290 291 292 293 294 295 296 297
	298 299 300 301 302 303 304 305 306 307 308 309 310 311 312 313 314 315 316 317 318 319 320 321 322 323 324 325 326 327
	328 329 
}

pacifica_area = {
	330 331 332 333 334 335 336 337 338 339 340 341 342 343 344 345 346 347 348 349 350 351 352 353 354 355 356 357 358 359 360
	361 
}
#Lakes:
#Listed by themselves in order to be easier to remove if needed.

#Land Areas:
# A land area is 3 - 10 provinces
#Fuck you paradox i make my areas more provinces then that 

################
#CENTRAL MEXICO#
################

western_shore_a = {
	1 609 610 611 3 4 5 38 37 6 7 2 
}	

eastern_shore_a = {
	26 27 28 31 29 30 25 22 19 20 18 11 8 13 43 21 23 438 12 
}

southern_shore_a = {
	36 35 34 396 33 32 409 
}

xocotitlan_a = {
	48 9 437 47 10 
}

toluca_a = {
	470 49 467 464 466 463 469 468 465 462 51 471 472 474 478
}

petlacalco_a = {
	394 50 395 461 460 459 458 457 456 455 454 453 
}

tula_a = {
	15 14 440 439 442 441 443 444 44 430 431 434 45 433 435 432 450 451 
	
}

tlaxcala_a = {
	76 77 75 408 24 17 16 578 
}

tepeacac_a = {
	536 534 67 531 532 530 529 528 413 411 53 410 415 416 418 528 522 537
	526 525 523 521 423 421 419 420 415 424 426 427 
}

malinalco_a = {
	54 483 479 477 480 55 482 481 473 476 
}

cuahnahuac_a = {
	400 401 403 404 407 425 422 406 405 402 399 398 397 52 412 414
	417 422 
}

yohualtepec_a = {
	428 59 513 512 511 514 508 515 516 520 
}

oztoman_a = {
	494 489 475 488 487 486 491 492 493 56 484 490 57 485
}

#################
#SOUTHERN MEXICO#
#################

cihuatlan_a = {
	503 502 699 501 500 499 498 497 58 496
}

yope_a = {
	81 495 510 505 507 504 506 62
}

tututepec_a { 
	79 706 705 703 548 707 708 704 
}

tehuantepec_a = {
	709 710 80 554 555 552 550 63 553
}

teotitlan_a = {
	78 549 547 542 543 545 544 540 539 61 538 517 509 518 519 524 527
	541 60 546
}

tochtepec_a = {
	65 551 557 564 565 566 568 567 63 556 
}

############
#GULF COAST#
############

cuetlaxtlan_a = {
	66 574 562 563 561 560 559 558 577 573 569 68 570 535 571 572 576 575 
	
}

huasteca_a = {
	585 586 588 587 69 581 582 583 584 589 580 590 579 591 592 593 594 72
	71 596 595 73 129 599 446 448 447 445 
}

###########
#MICHOACAN#
###########

patzcuaro_a = {
	84 85 86 362 654 363 364 373 365 368 89 686 367 372 370 389 662 
	687 655 
}

zacatula_a = {
	92 701 393 660 659 658 657 390 661 663 664 91 667 392 665 666 391 
	88 656 668 
}

cuitzeo_a = {
	369 377 692 693 371 366 688 374 691 382 700 690 685 688 695 379 381
	689 694
}

chapala_a = {
	103 111 110 96 376 684 683 682 681 674 384 675 385 670 669 671 672 384
	673 679 678 90 383 677 680 375 97 676 715
}

tetellan_a = {
	452 449 378 380 388 697 696 386 698 87 387 388
}

################
#WESTERN MEXICO#
################

colima_a = {
	93 94 95 108 107 109 117 118 711 713
}

xalisco_a = {
	119 116 115 114 112 113 120 121 718 717 716 714
}

cora_a = {	
	123 122 224 228 225 236 237 226 227 
}

tonallan_a = {
	222 106 223 224 105 104 102 101 100 99 98 125 124 719 720 721 722 723 724
}

######################
#NORTH CENTRAL MEXICO#
######################

metztitlan_a = {
	82 436 597 598 74 126 46 128 127 229 230 231 232 233 235 234 
}

#################
#MAYAN HIGHLANDS#
#################

xoconochco_a = {
	607 600 64 601 602 603 604 605 606 608 194 178 172 193 
}

west_highlands_a = {
	195 640 644 646 645 643 642 641 197 196 198 200 647 648 649 639 
}

east_highlands_a = {
	203 651 204 650 206 202 201 199
}

#########
#ISTHMUS#
#########

isthmus_a = {
	187 205 207 218 219 208 189 188 209 221 220 210 211 212 214 213 215 
	216 217
}

#########
#YUCATAN#
#########

xicalango_a = {
	192 190 191 177 176 174 173 171 175 170 169 165 168 164 160 159 
	156 157 155 154 153 
}

peten_a = {
	167 166 184 186 182 181 180 183 185 179 163 614 162 613
}

mayapan_a = {
	150 637 152 151 635 634 636 146 633 145 632 148 144 142 638 147
}

chichen_itza_a = {
	615 616 158 617 620 618 619 149 141 621 625 140 623 622 624  
	138 137 631  
}

ekab_a = {
	626 627 139 628 630 629 132 130 131 133 134 135 136
}

